0 *x** -> e 1
0 *e** -> x 2
1 ***x -> s 3
1 ***s -> x 0
2 x*** -> n 0
2 N*** -> x 3
3 **x* -> w 2
3 **w* -> x 1
